############
#...#......#
..#.#.####.#
###.#....#.#
#.....##.#..
######.#.#.#
#..#.#.#.#.#
##.#.#.#.#.#
#........#.#
#####.####.#
#.......#..#
############
